0000000000000000000000000000000000000000000000000000000-0000000000000000
0-00000000000000000000000000000000000000000000000000000-0000000000000000
0-00000000000000000000000000000000000000000000000000000-0000000000000000
0-00000000000000000000000000000000000000000000000000000-0000000000000000
0-00000000000000000000000000000000000000000000000000000-0000000000000000
0-00000000000000000000000000000000000000000000000000000-0000000000000000
012222222222222222222222222222222222222222222222222222230000000000000000
045555555555555555555555555555555555555555555555555555560000000000000000
045555555555555555555555555555555555555555555555555555560000000000000000
045555555555555555555555555555555555555555555555555555560000000000000000
045555555555555555555555555555555555555555555555555555560000000000000000
045555555555555555555555555555555555555555555555555555560000000000000000
045555555555555555555555555555555555555555555555555555560000000000000000
045555555555555555555555555555555555555555555555555555560000000000000000
045555555555555555555555555555555555555555555555555555560000000000000000
045555555555555555555555555555555555555555555555555555560000000000000000
045555555555555555555555555555555555555555555555555555560000000000000000
000000000000000000000000000000000000000000000000000000000000000000000000
000000000000000000000000000000000000000000000000000000000000000000000000
000000000000000000000000000000000000000000000000000000000000000000000000
000000000000000000000000000000000000000000000000000000000000000000000000
