000000000000000000000000000000000000000000000000000000000000000000000000
000000000000000000000000000000000000000000000000000000000000000000000000
000000000000000000000000000000000000000000000000000000000000000000000000
000000000000000000000000000000000000000000000000000000000000000000000000
0000000000000000000000000000000000p0p00000000000000000000000000000000000
000q00p000000000000000000q0000001222300000000000000000000000000000000000
00012223000000000q0p0000122230005g5550000000000000000p000q00000000000000
0005555g00000000122230005555g0005555h00000qq0000000001222300000000000000
00055g550p0000005gh5500055g550005g55500000122230000005555500000000000000
000555550122230055h550005555g0005555500000555550000005hg5500000000000000
00055h550h55550055g55000555h50005555500000g55h500000055h5500000000000000
000555550555g5005555500055555000000000000055555000000g555500000000000000
000000000555550055555000000000000000000000h55g50000005555500000000000000
00000000055gh50000000000000000000000000000555550000000000000000000000000
000000000555550000000000000000000000000000000000000000000000000000000000
000000000000000000000000000000000000000000000000000000000000000000000000
000000000000000000000000000000000000000000000000000000000000000000000000
000000000000000000000000000000000000000000000000000000000000000000000000
000000000000000000000000000000000000000000000000000000000000000000000000
000000000000000000000000000000000000000000000000000000000000000000000000
000000000000000000000000000000000000000000000000000000000000000000000000
